S11111111101100
000011111100001
111010000001101
111010101011101
111010101010101
100011101010001
101000001011111
101101101000110
101101101110100
111101100010001
100000111111111
101111100010000
101000001000101
100011101111101
1110111000011F1